25 25 25 25 25 25 25 25 25 25 25 25 25 25 25 25 25 25 25 25 25 25 25 25 25 25 25 25 25 25
25 0 0 2 0 0 0 0 0 0 0 18 0 0 0 0 0 0 0 0 0 0 0 0 0 0 1 0 0 25
25 25 25 25 25 0 0 0 0 0 18 0 0 0 0 0 0 0 0 0 3 0 0 0 0 25 25 25 25 25
25 0 0 0 0 0 1 0 0 18 0 0 0 0 0 0 0 25 0 0 25 25 25 0 0 0 0 0 0 25
25 0 0 0 0 21 22 23 0 0 0 0 0 0 13 15 0 0 2 0 0 0 0 0 13 15 0 0 0 25
25 0 0 22 0 0 0 0 0 3 2 0 0 0 0 0 0 21 22 23 0 0 0 13 15 0 15 0 0 25
25 0 0 0 0 0 0 0 0 21 22 23 0 0 0 0 0 0 0 0 0 0 13 14 15 0 0 0 0 25
25 25 0 0 0 0 25 0 0 0 0 0 0 0 0 0 0 0 0 25 0 0 0 0 0 0 0 0 25 25
25 0 0 0 0 0 0 0 0 0 0 0 0 0 0 0 0 24 0 0 0 25 0 0 1 0 2 0 0 25
25 25 0 13 15 0 0 4 0 13 15 0 0 0 0 0 24 0 0 0 0 0 0 21 22 22 23 0 0 25
25 0 0 0 0 0 13 15 0 0 0 0 24 0 0 24 0 0 0 0 0 0 0 0 0 0 0 0 24 25
25 0 0 0 0 0 0 0 0 0 25 0 0 24 0 0 0 3 1 0 2 0 0 15 0 0 0 13 15 25
25 0 0 0 24 0 0 0 14 0 0 0 0 0 24 0 0 16 17 17 17 2 0 18 0 25 0 16 18 25
25 0 4 24 0 0 0 0 0 14 1 0 0 0 0 0 0 0 0 0 19 17 17 20 0 0 0 16 18 25
25 0 24 0 0 0 24 0 0 21 22 23 0 0 0 25 0 25 0 0 0 0 0 0 0 0 19 17 20 25
25 24 0 0 25 0 0 24 0 0 0 21 23 0 0 0 0 0 0 4 0 0 0 0 0 14 0 0 0 25
25 0 0 25 0 25 0 0 24 0 0 0 0 22 0 0 0 0 24 24 0 0 0 0 14 0 0 0 0 25
25 1 0 0 0 0 25 0 24 0 24 0 0 0 0 19 17 17 17 17 20 0 0 14 0 0 0 0 0 25
25 25 0 0 2 0 0 0 24 24 0 0 0 1 1 0 4 0 0 2 0 0 14 0 0 0 0 0 0 25
25 25 25 25 25 25 25 25 25 25 25 25 25 25 25 25 25 25 25 25 25 25 25 25 25 25 25 25 25 25
